################################################################################
#..............................................................................#
#..............................................................................#
#....######.....########.....########.......###.......########....########.....#
#...##....##....##.....##....##............##.##.........##.......##...........#
#...##..........##.....##....##...........##...##........##.......##...........#
#...##..........########.....######......##.....##.......##.......######.......#
#...##..........##...##......##..........#########.......##.......##...........#
#...##....##....##....##.....##..........##.....##.......##.......##...........#
#....######.....##.....##....########....##.....##.......##.......########.....#
#..............................................................................#
#............########.....##....##.......########...######..##.................#
#............##.....##.....##..##........##.....##.##....##.##.................#
#............##.....##......####.........##.....##.##.......##.................#
#............########........##..........########...######..##.................#
#............##.....##.......##..........##.....##.......##.##.................#
#............##.....##.......##..........##.....##.##....##.##.................#
#............########........##..........########...######..########...........#
#..............................................................................#
#..............................................................................#
#.....................#######....#####....#######.....##.......................#
#....................##.....##..##...##..##.....##..####.......................#
#...........................##.##.....##........##....##.......................#
#.....................#######..##.....##..#######.....##.......................#
#....................##........##.....##.##...........##.......................#
#....................##.........##...##..##...........##.......................#
#....................#########...#####...#########..######.....................#
#..............................................................................#
#..............................................................................#
################################################################################